   GGGGGGGGGG   
 GFFFGGGGGGGFGF 
GFFGGGGGIIGGGGGG
GGGGGGGIGGGGGGGG
GGGGGGGWGGGGGGGG
GGGGGGGGGGGGGGGG
GGGGWGGGGWGGGGGG
GGGWGGGGGGGGGGGG
GGGGGGGGFFGFGGGG
 GGGGGGGGGFFGGG 
   GGGGGGGGGG 