   GGGGG   
 GFFGGGFGF 
GFFGGIGGGGG
GGGGIGGGGGG
GGGGWGGGGGG
GGGGGGGGGGG
GGGGGGGGGGG
GGGWGGGGGGG
GGGGGFFGGGG
 GGGGGFGGG 
   GGGGG 