PPPPPPPPPPPPPPPP
PFFPPPPPPPPPLLLP
PFFPPPPPPPMMPLLP
PPPPPMMMMMPPPPPP
PPPPMMMMMMMPPPPP
PPPPPPMMMPPPPPPP
PPPPPPPPPPPPPPPF
PPPPPPPPPPPPPFFF