GGGGGGGGGGG
GFFIGGGGGGG
GFFIGGGGIIG
GGGGGGGGGGG
WWWWWWWWGGG
GGGGGGGGGGG