GGGGGGGGG
GFFIGGGGG
GFFIGGGGI
GGGGGGGGG
WWWWWWWWG
GGGGGGGGG