GGGGGGGGGGG
GFFIGGGGGGG
GFFIGGGGIIG
GGGGGGGGGGG
GGWWGGGWGGG
GGGGGGGGGGG
WWWWWWWWGGG
WWWWWWWWGGG
WWWWWWWWGGG
GGGGGGGGGGF
FFFFFFFFFFF